111111111111111
1E00C00CP011111
110001000111111
1000100V0111111
111111111111111